#########################################
#S......................................#
#A......................................#
#A......................................#
#A......................................#
#A......................................#
#A......................................#
#A......................................#
#A......................................#
#.......................................#
#.......................................#
#.......................................#
#.......................................#
#.......................................#
#.......................................#
#.......................................#
#.......................................#
#.......................................#
#.......................................#
#.......................................#
#.......................................#
#.......................................#
#.......................................#
#.......................................#
#.......................................#
#.......................................#
#.......................................#
#.......................................#
#.......................................#
#.......................................#
#.......................................#
#.......................................#
#.......................................#
#.......................................#
#.......................................#
#.......................................#
#.......................................#
#.......................................#
#.......................................#
#.......................................#
#.......................................#
#.......................................#
#.......................................#
#.......................................#
#.......................................#
#.......................................#
#.......................................#
#.......................................#
#.......................................#
#.......................................#
#.......................................#
#.......................................#
#.......................................#
#.......................................#
#.......................................#
#.......................................#
#########################################
