#################
#.S.####..#....##
#.........#....##
#..E...A..#....##
#####.###.#....##
#####.###......##
#.....###.#....##
#####.###.#....##
#####.....#....##
#####.###.#....##
#####.###.#.....#
#####.....#.###.#
######...##.....#
############...##
#################
