########################
#SAAAAAAAAAAAAAAAAAAAAA#
##############.........#
##############.........#
#............#.........#
#......................#
#......................#
#......................#
#......................#
#.....#................#
#.....#................#
#.....#................#
########################
