###########
#.S.####..#
#.........#
#.........#
#####.###.#
#####.###.#
#.....###.#
#####.###.#
#####.....#
#####.###.#
#####.###.#
#####.....#
######...##
###########
