###########
#.S.####..#
#........A#
#......A..#
#####.###.#
#####.###.#
#.....###.#
#####.###.#
#####....A#
#####.###.#
#####.###.#
#####.....#
######.A.##
###########
