#################
#.S.####..#....##
#........A#.A..##
#......A..#..A.##
#####.###.#.A..##
#####.###....A.##
#.....###.#.A..##
#####.###.#..A.##
#####....A#.A..##
#####.###.#..A.##
#####.###.#.....#
#####..E..#.###.#
######.A.##.....#
#################
